,dteday,registered,casual,weekday,mnth,cnt,holiday,workingday
0,2016-01-01,16,2,4,3,18,1,0
1,2016-01-02,16,1,5,3,17,0,0
2,2016-01-03,23,1,6,3,24,0,0
3,2016-01-04,76,1,0,3,77,0,1
4,2016-01-05,85,2,1,3,87,0,1
5,2016-01-06,105,1,2,3,106,0,1
6,2016-01-07,103,3,3,3,106,0,1
7,2016-01-08,66,5,4,3,71,0,1
8,2016-01-09,38,0,5,3,38,0,0
9,2016-01-10,19,0,6,3,19,0,0
10,2016-01-11,46,0,0,3,46,0,1
11,2016-01-12,37,0,1,3,37,0,1
12,2016-01-13,47,0,2,3,47,0,1
13,2016-01-14,105,1,3,3,106,0,1
14,2016-01-15,90,4,4,3,94,0,1
15,2016-01-16,40,4,5,3,44,0,0
16,2016-01-17,15,0,6,3,15,0,0
17,2016-01-18,37,0,0,3,37,1,0
18,2016-01-19,58,0,1,3,58,0,1
19,2016-01-20,50,0,2,3,50,0,1
20,2016-01-21,72,1,3,3,73,0,1
21,2016-01-22,91,1,4,3,92,0,1
22,2016-01-23,42,1,5,3,43,0,0
23,2016-01-24,37,0,6,3,37,0,0
24,2016-01-25,71,9,0,3,80,0,1
25,2016-01-26,94,2,1,3,96,0,1
26,2016-01-27,69,1,2,3,70,0,1
27,2016-01-28,98,0,3,3,98,0,1
28,2016-01-29,88,4,4,3,92,0,1
29,2016-01-30,66,13,5,3,79,0,0
30,2016-01-31,39,5,6,3,44,0,0
31,2016-02-01,109,11,0,3,120,0,1
32,2016-02-02,61,0,1,3,61,0,1
33,2016-02-03,77,2,2,3,79,0,1
34,2016-02-04,97,1,3,3,98,0,1
35,2016-02-05,83,4,4,3,87,0,1
36,2016-02-06,60,14,5,3,74,0,0
37,2016-02-07,57,6,6,3,63,0,0
38,2016-02-08,75,1,0,3,76,0,1
39,2016-02-09,65,1,1,3,66,0,1
40,2016-02-10,51,1,2,3,52,0,1
41,2016-02-11,65,1,3,3,66,0,1
42,2016-02-12,64,3,4,3,67,0,1
43,2016-02-13,27,0,5,3,27,0,0
44,2016-02-14,14,0,6,3,14,0,0
45,2016-02-15,43,3,0,3,46,0,1
46,2016-02-16,72,2,1,3,74,0,1
47,2016-02-17,94,1,2,3,95,0,1
48,2016-02-18,102,4,3,3,106,0,1
49,2016-02-19,107,4,4,3,111,0,1
50,2016-02-20,100,68,5,3,168,0,0
51,2016-02-21,49,7,6,3,56,0,0
52,2016-02-22,96,3,0,3,99,0,1
53,2016-02-23,98,1,1,3,99,0,1
54,2016-02-24,53,0,2,3,53,0,1
55,2016-02-25,99,1,3,3,100,0,1
56,2016-02-26,91,3,4,3,94,0,1
57,2016-02-27,74,33,5,3,107,0,0
58,2016-02-28,78,46,6,3,124,0,0
59,2016-02-29,105,7,0,3,112,0,1
60,2016-03-01,64,0,1,3,64,0,1
61,2016-03-02,77,4,2,3,81,0,1
62,2016-03-03,66,2,3,3,68,0,1
63,2016-03-04,85,1,4,3,86,0,1
64,2016-03-05,45,8,5,3,53,0,0
65,2016-03-06,63,17,6,3,80,0,0
66,2016-03-07,142,18,0,3,160,0,1
67,2016-03-08,165,41,1,3,206,0,1
68,2016-03-09,162,23,2,3,185,0,1
69,2016-03-10,139,10,3,3,149,0,1
70,2016-03-11,138,19,4,3,157,0,1
71,2016-03-12,88,39,5,3,127,0,0
72,2016-03-13,24,7,6,3,31,0,0
73,2016-03-14,122,24,0,3,146,0,1
74,2016-03-15,148,13,1,3,161,0,1
75,2016-03-16,110,14,2,3,124,0,1
76,2016-03-17,128,27,3,3,155,0,1
77,2016-03-18,124,15,4,3,139,0,1
78,2016-03-19,59,16,5,3,75,0,0
79,2016-03-20,44,27,6,3,71,0,0
80,2016-03-21,125,21,0,3,146,0,1
81,2016-03-22,152,32,1,3,184,0,1
82,2016-03-23,90,10,2,3,100,0,1
83,2016-03-24,46,1,3,3,47,0,1
84,2016-03-25,93,22,4,3,115,0,1
85,2016-03-26,93,60,5,3,153,0,0
86,2016-03-27,54,44,6,3,98,0,0
87,2016-03-28,122,5,0,3,127,0,1
88,2016-03-29,137,19,1,3,156,0,1
89,2016-03-30,140,13,2,3,153,0,1
90,2016-03-31,109,13,3,3,122,0,1
91,2016-04-01,98,14,4,3,112,0,1
92,2016-04-02,48,15,5,3,63,0,0
93,2016-04-03,68,40,6,3,108,0,0
94,2016-04-04,90,1,0,3,91,0,1
95,2016-04-05,101,10,1,3,111,0,1
96,2016-04-06,74,2,2,3,76,0,1
97,2016-04-07,95,2,3,3,97,0,1
98,2016-04-08,82,0,4,3,82,0,1
99,2016-04-09,41,11,5,3,52,0,0
100,2016-04-10,28,2,6,3,30,0,0
101,2016-04-11,153,11,0,3,164,0,1
102,2016-04-12,138,4,1,3,142,0,1
103,2016-04-13,136,18,2,3,154,0,1
104,2016-04-14,164,18,3,3,182,0,1
105,2016-04-15,167,38,4,3,205,0,1
106,2016-04-16,147,152,5,3,299,0,0
107,2016-04-17,134,160,6,3,294,0,0
108,2016-04-18,198,65,0,3,263,0,1
109,2016-04-19,165,19,1,3,184,0,1
110,2016-04-20,184,14,2,3,198,0,1
111,2016-04-21,161,22,3,3,183,0,1
112,2016-04-22,118,29,4,3,147,0,1
113,2016-04-23,102,92,5,3,194,0,0
114,2016-04-24,157,168,6,3,325,0,0
115,2016-04-25,195,58,0,3,253,0,1
116,2016-04-26,128,14,1,3,142,0,1
117,2016-04-27,88,4,2,3,92,0,1
118,2016-04-28,138,10,3,3,148,0,1
119,2016-04-29,130,19,4,3,149,0,1
120,2016-04-30,22,5,5,3,27,0,0
121,2016-05-01,54,15,6,3,69,0,0
122,2016-05-02,152,18,0,3,170,0,1
123,2016-05-03,213,35,1,3,248,0,1
124,2016-05-04,152,15,2,3,167,0,1
125,2016-05-05,170,15,3,3,185,0,1
126,2016-05-06,217,83,4,3,300,0,1
127,2016-05-07,81,51,5,3,132,0,0
128,2016-05-08,133,123,6,3,256,0,0
129,2016-05-09,130,16,0,3,146,0,1
130,2016-05-10,109,5,1,3,114,0,1
131,2016-05-11,181,19,2,3,200,0,1
132,2016-05-12,186,32,3,3,218,0,1
133,2016-05-13,172,55,4,3,227,0,1
134,2016-05-14,85,11,5,3,96,0,0
135,2016-05-15,114,50,6,3,164,0,0
136,2016-05-16,203,52,0,3,255,0,1
137,2016-05-17,175,15,1,3,190,0,1
138,2016-05-18,197,16,2,3,213,0,1
139,2016-05-19,242,49,3,3,291,0,1
140,2016-05-20,184,50,4,3,234,0,1
141,2016-05-21,151,150,5,3,301,0,0
142,2016-05-22,159,162,6,3,321,0,0
143,2016-05-23,273,90,0,3,363,0,1
144,2016-05-24,230,67,1,3,297,0,1
145,2016-05-25,175,41,2,3,216,0,1
146,2016-05-26,242,69,3,3,311,0,1
147,2016-05-27,202,60,4,3,262,0,1
148,2016-05-28,127,164,5,3,291,0,0
149,2016-05-29,149,224,6,3,373,0,0
150,2016-05-30,178,218,0,3,396,1,0
151,2016-05-31,163,42,1,3,205,0,1
152,2016-06-01,197,41,2,3,238,0,1
153,2016-06-02,267,68,3,3,335,0,1
154,2016-06-03,249,85,4,3,334,0,1
155,2016-06-04,149,73,5,3,222,0,0
156,2016-06-05,187,148,6,3,335,0,0
157,2016-06-06,252,86,0,3,338,0,1
158,2016-06-07,268,52,1,3,320,0,1
159,2016-06-08,248,62,2,3,310,0,1
160,2016-06-09,205,26,3,3,231,0,1
161,2016-06-10,274,92,4,3,366,0,1
162,2016-06-11,181,173,5,3,354,0,0
163,2016-06-12,158,121,6,3,279,0,0
164,2016-06-13,287,70,0,3,357,0,1
165,2016-06-14,241,41,1,3,282,0,1
166,2016-06-15,255,49,2,3,304,0,1
167,2016-06-16,246,47,3,3,293,0,1
168,2016-06-17,294,90,4,3,384,0,1
169,2016-06-18,227,208,5,3,435,0,0
170,2016-06-19,157,155,6,3,312,0,0
171,2016-06-20,292,53,0,3,345,0,1
172,2016-06-21,278,75,1,3,353,0,1
173,2016-06-22,208,35,2,3,243,0,1
174,2016-06-23,253,80,3,3,333,0,1
175,2016-06-24,301,117,4,3,418,0,1
176,2016-06-25,202,177,5,3,379,0,0
177,2016-06-26,173,116,6,3,289,0,0
178,2016-06-27,272,78,0,3,350,0,1
179,2016-06-28,277,55,1,3,332,0,1
180,2016-06-29,299,75,2,3,374,0,1
181,2016-06-30,285,64,3,3,349,0,1
182,2016-07-01,256,84,4,3,340,0,1
183,2016-07-02,155,193,5,3,348,0,0
184,2016-07-03,138,244,6,3,382,0,0
185,2016-07-04,142,194,0,3,336,1,0
186,2016-07-05,270,89,1,3,359,0,1
187,2016-07-06,224,47,2,3,271,0,1
188,2016-07-07,221,57,3,3,278,0,1
189,2016-07-08,269,91,4,3,360,0,1
190,2016-07-09,228,198,5,3,426,0,0
191,2016-07-10,172,191,6,3,363,0,0
192,2016-07-11,238,74,0,3,312,0,1
193,2016-07-12,283,53,1,3,336,0,1
194,2016-07-13,193,42,2,3,235,0,1
195,2016-07-14,258,78,3,3,336,0,1
196,2016-07-15,237,67,4,3,304,0,1
197,2016-07-16,223,267,5,3,490,0,0
198,2016-07-17,167,166,6,3,333,0,0
199,2016-07-18,265,71,0,3,336,0,1
200,2016-07-19,288,89,1,3,377,0,1
201,2016-07-20,268,64,2,3,332,0,1
202,2016-07-21,261,49,3,3,310,0,1
203,2016-07-22,257,95,4,3,352,0,1
204,2016-07-23,129,101,5,3,230,0,0
205,2016-07-24,143,72,6,3,215,0,0
206,2016-07-25,277,69,0,3,346,0,1
207,2016-07-26,269,68,1,3,337,0,1
208,2016-07-27,294,71,2,3,365,0,1
209,2016-07-28,230,56,3,3,286,0,1
210,2016-07-29,216,56,4,3,272,0,1
211,2016-07-30,206,163,5,3,369,0,0
212,2016-07-31,186,164,6,3,350,0,0
213,2016-08-01,269,112,0,3,381,0,1
214,2016-08-02,244,88,1,3,332,0,1
215,2016-08-03,275,62,2,3,337,0,1
216,2016-08-04,262,64,3,3,326,0,1
217,2016-08-05,259,82,4,3,341,0,1
218,2016-08-06,183,208,5,3,391,0,0
219,2016-08-07,169,162,6,3,331,0,0
220,2016-08-08,230,106,0,3,336,0,1
221,2016-08-09,325,58,1,3,383,0,1
222,2016-08-10,270,61,2,3,331,0,1
223,2016-08-11,248,77,3,3,325,0,1
224,2016-08-12,139,32,4,3,171,0,1
225,2016-08-13,157,148,5,3,305,0,0
226,2016-08-14,175,155,6,3,330,0,0
227,2016-08-15,193,55,0,3,248,0,1
228,2016-08-16,288,69,1,3,357,0,1
229,2016-08-17,260,68,2,3,328,0,1
230,2016-08-18,227,43,3,3,270,0,1
231,2016-08-19,256,95,4,3,351,0,1
232,2016-08-20,121,123,5,3,244,0,0
233,2016-08-21,167,155,6,3,322,0,0
234,2016-08-22,293,97,0,3,390,0,1
235,2016-08-23,310,65,1,3,375,0,1
236,2016-08-24,187,31,2,3,218,0,1
237,2016-08-25,227,35,3,3,262,0,1
238,2016-08-26,244,97,4,3,341,0,1
239,2016-08-27,160,121,5,3,281,0,0
240,2016-08-28,171,138,6,3,309,0,0
241,2016-08-29,250,65,0,3,315,0,1
242,2016-08-30,224,47,1,3,271,0,1
243,2016-08-31,270,38,2,3,308,0,1
244,2016-09-01,230,27,3,3,257,0,1
245,2016-09-02,260,85,4,3,345,0,1
246,2016-09-03,151,203,5,3,354,0,0
247,2016-09-04,141,233,6,3,374,0,0
248,2016-09-05,148,204,0,3,352,1,0
249,2016-09-06,229,37,1,3,266,0,1
250,2016-09-07,262,35,2,3,297,0,1
251,2016-09-08,235,33,3,3,268,0,1
252,2016-09-09,217,52,4,3,269,0,1
253,2016-09-10,147,85,5,3,232,0,0
254,2016-09-11,168,127,6,3,295,0,0
255,2016-09-12,244,71,0,3,315,0,1
256,2016-09-13,264,42,1,3,306,0,1
257,2016-09-14,279,45,2,3,324,0,1
258,2016-09-15,247,60,3,3,307,0,1
259,2016-09-16,243,52,4,3,295,0,1
260,2016-09-17,176,141,5,3,317,0,0
261,2016-09-18,181,175,6,3,356,0,0
262,2016-09-19,272,78,0,3,350,0,1
263,2016-09-20,257,55,1,3,312,0,1
264,2016-09-21,184,28,2,3,212,0,1
265,2016-09-22,258,41,3,3,299,0,1
266,2016-09-23,238,60,4,3,298,0,1
267,2016-09-24,164,158,5,3,322,0,0
268,2016-09-25,183,111,6,3,294,0,0
269,2016-09-26,240,50,0,3,290,0,1
270,2016-09-27,227,29,1,3,256,0,1
271,2016-09-28,168,9,2,3,177,0,1
272,2016-09-29,169,6,3,3,175,0,1
273,2016-09-30,164,22,4,3,186,0,1
274,2016-10-01,91,41,5,3,132,0,0
275,2016-10-02,130,58,6,3,188,0,0
276,2016-10-03,244,37,0,3,281,0,1
277,2016-10-04,270,39,1,3,309,0,1
278,2016-10-05,280,25,2,3,305,0,1
279,2016-10-06,113,13,3,3,126,0,1
280,2016-10-07,257,61,4,3,318,0,1
281,2016-10-08,160,107,5,3,267,0,0
282,2016-10-09,134,111,6,3,245,0,0
283,2016-10-10,213,93,0,3,306,0,1
284,2016-10-11,248,58,1,3,306,0,1
285,2016-10-12,139,12,2,3,151,0,1
286,2016-10-13,224,32,3,3,256,0,1
287,2016-10-14,214,50,4,3,264,0,1
288,2016-10-15,145,89,5,3,234,0,0
289,2016-10-16,118,51,6,3,169,0,0
290,2016-10-17,237,58,0,3,295,0,1
291,2016-10-18,236,40,1,3,276,0,1
292,2016-10-19,231,23,2,3,254,0,1
293,2016-10-20,192,15,3,3,207,0,1
294,2016-10-21,198,30,4,3,228,0,1
295,2016-10-22,133,67,5,3,200,0,0
296,2016-10-23,114,127,6,3,241,0,0
297,2016-10-24,218,23,0,3,241,0,1
298,2016-10-25,225,16,1,3,241,0,1
299,2016-10-26,81,2,2,3,83,0,1
300,2016-10-27,162,18,3,3,180,0,1
301,2016-10-28,228,35,4,3,263,0,1
302,2016-10-29,160,99,5,3,259,0,0
303,2016-10-30,100,38,6,3,138,0,0
304,2016-10-31,173,24,0,3,197,0,1
305,2016-11-01,244,21,1,3,265,0,1
306,2016-11-02,168,10,2,3,178,0,1
307,2016-11-03,205,36,3,3,241,0,1
308,2016-11-04,212,74,4,3,286,0,1
309,2016-11-05,115,109,5,3,224,0,0
310,2016-11-06,147,106,6,3,253,0,0
311,2016-11-07,217,24,0,3,241,0,1
312,2016-11-08,193,11,1,3,204,0,1
313,2016-11-09,194,2,2,3,196,0,1
314,2016-11-10,197,17,3,3,214,0,1
315,2016-11-11,140,15,4,3,155,1,0
316,2016-11-12,98,48,5,3,146,0,0
317,2016-11-13,105,42,6,3,147,0,0
318,2016-11-14,192,13,0,3,205,0,1
319,2016-11-15,169,15,1,3,184,0,1
320,2016-11-16,215,8,2,3,223,0,1
321,2016-11-17,208,25,3,3,233,0,1
322,2016-11-18,136,10,4,3,146,0,1
323,2016-11-19,67,8,5,3,75,0,0
324,2016-11-20,52,8,6,3,60,0,0
325,2016-11-21,129,1,0,3,130,0,1
326,2016-11-22,144,3,1,3,147,0,1
327,2016-11-23,57,2,2,3,59,0,1
328,2016-11-24,19,8,3,3,27,1,0
329,2016-11-25,34,14,4,3,48,0,1
330,2016-11-26,51,19,5,3,70,0,0
331,2016-11-27,61,4,6,3,65,0,0
332,2016-11-28,80,1,0,3,81,0,1
333,2016-11-29,162,10,1,3,172,0,1
334,2016-11-30,133,3,2,3,136,0,1
335,2016-12-01,128,2,3,3,130,0,1
336,2016-12-02,119,4,4,3,123,0,1
337,2016-12-03,61,5,5,3,66,0,0
338,2016-12-04,24,0,6,3,24,0,0
339,2016-12-05,116,1,0,3,117,0,1
340,2016-12-06,113,1,1,3,114,0,1
341,2016-12-07,112,0,2,3,112,0,1
342,2016-12-08,76,0,3,3,76,0,1
343,2016-12-09,89,1,4,3,90,0,1
344,2016-12-10,28,4,5,3,32,0,0
345,2016-12-11,16,0,6,3,16,0,0
346,2016-12-12,55,0,0,3,55,0,1
347,2016-12-13,56,0,1,3,56,0,1
348,2016-12-14,56,1,2,3,57,0,1
349,2016-12-15,36,0,3,3,36,0,1
350,2016-12-16,51,1,4,3,52,0,1
351,2016-12-17,14,1,5,3,15,0,0
352,2016-12-18,13,0,6,3,13,0,0
353,2016-12-19,32,0,0,3,32,0,1
354,2016-12-20,51,0,1,3,51,0,1
355,2016-12-21,68,0,2,3,68,0,1
356,2016-12-22,75,3,3,3,78,0,1
357,2016-12-23,43,3,4,3,46,0,1
358,2016-12-24,16,0,5,3,16,0,0
359,2016-12-25,10,0,6,3,10,1,0
360,2016-12-26,29,6,0,3,35,0,1
361,2016-12-27,45,5,1,3,50,0,1
362,2016-12-28,60,7,2,3,67,0,1
363,2016-12-29,52,3,3,3,55,0,1
364,2016-12-30,48,6,4,3,54,0,1
365,2016-12-31,26,6,5,3,32,0,0
