,dteday,registered,casual,weekday,mnth,cnt,holiday,workingday
0,2016-01-01,41,18,4,3,59,1,0
1,2016-01-02,77,32,5,3,109,0,0
2,2016-01-03,73,23,6,3,96,0,0
3,2016-01-04,101,6,0,3,107,0,1
4,2016-01-05,83,4,1,3,87,0,1
5,2016-01-06,109,2,2,3,111,0,1
6,2016-01-07,123,3,3,3,126,0,1
7,2016-01-08,107,8,4,3,115,0,1
8,2016-01-09,91,14,5,3,105,0,0
9,2016-01-10,89,13,6,3,102,0,0
10,2016-01-11,111,6,0,3,117,0,1
11,2016-01-12,125,5,1,3,130,0,1
12,2016-01-13,114,6,2,3,120,0,1
13,2016-01-14,148,7,3,3,155,0,1
14,2016-01-15,124,17,4,3,141,0,1
15,2016-01-16,84,27,5,3,111,0,0
16,2016-01-17,43,13,6,3,56,0,0
17,2016-01-18,48,4,0,3,52,1,0
18,2016-01-19,78,0,1,3,78,0,1
19,2016-01-20,78,1,2,3,79,0,1
20,2016-01-21,96,3,3,3,99,0,1
21,2016-01-22,54,0,4,3,54,0,1
22,2016-01-27,11,0,2,3,11,0,1
23,2016-01-28,41,0,3,3,41,0,1
24,2016-01-29,49,0,4,3,49,0,1
25,2016-01-30,55,4,5,3,59,0,0
26,2016-01-31,59,6,6,3,65,0,0
27,2016-02-01,77,1,0,3,78,0,1
28,2016-02-02,108,2,1,3,110,0,1
29,2016-02-03,77,1,2,3,78,0,1
30,2016-02-04,134,7,3,3,141,0,1
31,2016-02-05,124,7,4,3,131,0,1
32,2016-02-06,85,15,5,3,100,0,0
33,2016-02-07,82,10,6,3,92,0,0
34,2016-02-08,118,7,0,3,125,0,1
35,2016-02-09,87,1,1,3,88,0,1
36,2016-02-10,89,3,2,3,92,0,1
37,2016-02-11,88,2,3,3,90,0,1
38,2016-02-12,77,7,4,3,84,0,1
39,2016-02-13,27,1,5,3,28,0,0
40,2016-02-14,32,12,6,3,44,0,0
41,2016-02-15,6,1,0,3,7,0,1
42,2016-02-16,65,2,1,3,67,0,1
43,2016-02-17,108,5,2,3,113,0,1
44,2016-02-18,101,5,3,3,106,0,1
45,2016-02-19,113,9,4,3,122,0,1
46,2016-02-20,98,57,5,3,155,0,0
47,2016-02-21,75,16,6,3,91,0,0
48,2016-02-22,124,9,0,3,133,0,1
49,2016-02-23,49,0,1,3,49,0,1
50,2016-02-24,57,2,2,3,59,0,1
51,2016-02-25,125,1,3,3,126,0,1
52,2016-02-26,94,5,4,3,99,0,1
53,2016-02-27,100,22,5,3,122,0,0
54,2016-02-28,106,57,6,3,163,0,0
55,2016-02-29,145,16,0,3,161,0,1
56,2016-03-01,156,13,1,3,169,0,1
57,2016-03-02,96,5,2,3,101,0,1
58,2016-03-03,118,6,3,3,124,0,1
59,2016-03-04,100,3,4,3,103,0,1
60,2016-03-05,85,19,5,3,104,0,0
61,2016-03-06,76,33,6,3,109,0,0
62,2016-03-07,144,28,0,3,172,0,1
63,2016-03-08,179,28,1,3,207,0,1
64,2016-03-09,185,41,2,3,226,0,1
65,2016-03-10,171,27,3,3,198,0,1
66,2016-03-11,164,51,4,3,215,0,1
67,2016-03-12,136,83,5,3,219,0,0
68,2016-03-13,78,32,6,3,110,0,0
69,2016-03-14,143,15,0,3,158,0,1
70,2016-03-15,136,22,1,3,158,0,1
71,2016-03-16,179,85,2,3,264,0,1
72,2016-03-17,179,44,3,3,223,0,1
73,2016-03-18,160,47,4,3,207,0,1
74,2016-03-19,52,10,5,3,62,0,0
75,2016-03-20,73,13,6,3,86,0,0
76,2016-03-21,157,15,0,3,172,0,1
77,2016-03-22,149,23,1,3,172,0,1
78,2016-03-23,184,55,2,3,239,0,1
79,2016-03-24,190,71,3,3,261,0,1
80,2016-03-25,159,71,4,3,230,0,1
81,2016-03-26,155,129,5,3,284,0,0
82,2016-03-27,91,71,6,3,162,0,0
83,2016-03-28,135,27,0,3,162,0,1
84,2016-03-29,177,35,1,3,212,0,1
85,2016-03-30,197,41,2,3,238,0,1
86,2016-03-31,179,45,3,3,224,0,1
87,2016-04-01,173,50,4,3,223,0,1
88,2016-04-02,108,71,5,3,179,0,0
89,2016-04-03,94,20,6,3,114,0,0
90,2016-04-04,128,16,0,3,144,0,1
91,2016-04-05,137,12,1,3,149,0,1
92,2016-04-06,155,18,2,3,173,0,1
93,2016-04-07,90,11,3,3,101,0,1
94,2016-04-08,155,32,4,3,187,0,1
95,2016-04-09,63,18,5,3,81,0,0
96,2016-04-10,94,56,6,3,150,0,0
97,2016-04-11,165,28,0,3,193,0,1
98,2016-04-12,173,14,1,3,187,0,1
99,2016-04-13,163,19,2,3,182,0,1
100,2016-04-14,172,15,3,3,187,0,1
101,2016-04-15,181,42,4,3,223,0,1
102,2016-04-16,138,107,5,3,245,0,0
103,2016-04-17,126,104,6,3,230,0,0
104,2016-04-18,166,48,0,3,214,0,1
105,2016-04-19,184,42,1,3,226,0,1
106,2016-04-20,212,32,2,3,244,0,1
107,2016-04-21,214,38,3,3,252,0,1
108,2016-04-22,160,44,4,3,204,0,1
109,2016-04-23,116,52,5,3,168,0,0
110,2016-04-24,160,81,6,3,241,0,0
111,2016-04-25,178,58,0,3,236,0,1
112,2016-04-26,189,40,1,3,229,0,1
113,2016-04-27,149,15,2,3,164,0,1
114,2016-04-28,101,11,3,3,112,0,1
115,2016-04-29,161,23,4,3,184,0,1
116,2016-04-30,105,75,5,3,180,0,0
117,2016-05-01,81,19,6,3,100,0,0
118,2016-05-02,143,27,0,3,170,0,1
119,2016-05-03,154,17,1,3,171,0,1
120,2016-05-04,173,21,2,3,194,0,1
121,2016-05-05,165,14,3,3,179,0,1
122,2016-05-06,73,3,4,3,76,0,1
123,2016-05-07,129,47,5,3,176,0,0
124,2016-05-08,122,77,6,3,199,0,0
125,2016-05-09,174,21,0,3,195,0,1
126,2016-05-10,185,29,1,3,214,0,1
127,2016-05-11,142,15,2,3,157,0,1
128,2016-05-12,174,29,3,3,203,0,1
129,2016-05-13,153,38,4,3,191,0,1
130,2016-05-14,107,73,5,3,180,0,0
131,2016-05-15,106,51,6,3,157,0,0
132,2016-05-16,178,44,0,3,222,0,1
133,2016-05-17,109,4,1,3,113,0,1
134,2016-05-18,185,27,2,3,212,0,1
135,2016-05-19,225,39,3,3,264,0,1
136,2016-05-20,200,60,4,3,260,0,1
137,2016-05-21,72,13,5,3,85,0,0
138,2016-05-22,50,4,6,3,54,0,0
139,2016-05-23,137,26,0,3,163,0,1
140,2016-05-24,198,37,1,3,235,0,1
141,2016-05-25,200,54,2,3,254,0,1
142,2016-05-26,199,45,3,3,244,0,1
143,2016-05-27,184,65,4,3,249,0,1
144,2016-05-28,121,116,5,3,237,0,0
145,2016-05-29,79,92,6,3,171,0,0
146,2016-05-30,119,95,0,3,214,1,0
147,2016-05-31,183,46,1,3,229,0,1
148,2016-06-01,205,30,2,3,235,0,1
149,2016-06-02,208,32,3,3,240,0,1
150,2016-06-03,128,33,4,3,161,0,1
151,2016-06-04,166,78,5,3,244,0,0
152,2016-06-05,119,68,6,3,187,0,0
153,2016-06-06,212,46,0,3,258,0,1
154,2016-06-07,229,53,1,3,282,0,1
155,2016-06-08,216,41,2,3,257,0,1
156,2016-06-09,230,49,3,3,279,0,1
157,2016-06-10,192,60,4,3,252,0,1
158,2016-06-11,163,75,5,3,238,0,0
159,2016-06-12,151,81,6,3,232,0,0
160,2016-06-13,216,53,0,3,269,0,1
161,2016-06-14,244,42,1,3,286,0,1
162,2016-06-15,222,36,2,3,258,0,1
163,2016-06-16,172,30,3,3,202,0,1
164,2016-06-17,236,75,4,3,311,0,1
165,2016-06-18,167,110,5,3,277,0,0
166,2016-06-19,135,90,6,3,225,0,0
167,2016-06-20,202,63,0,3,265,0,1
168,2016-06-21,153,27,1,3,180,0,1
169,2016-06-22,203,52,2,3,255,0,1
170,2016-06-23,147,35,3,3,182,0,1
171,2016-06-24,190,38,4,3,228,0,1
172,2016-06-25,138,120,5,3,258,0,0
173,2016-06-26,138,114,6,3,252,0,0
174,2016-06-27,178,44,0,3,222,0,1
175,2016-06-28,180,32,1,3,212,0,1
176,2016-06-29,235,50,2,3,285,0,1
177,2016-06-30,238,50,3,3,288,0,1
178,2016-07-01,185,52,4,3,237,0,1
179,2016-07-02,134,158,5,3,292,0,0
180,2016-07-03,112,155,6,3,267,0,0
181,2016-07-04,65,82,0,3,147,1,0
182,2016-07-05,188,66,1,3,254,0,1
183,2016-07-06,189,56,2,3,245,0,1
184,2016-07-07,192,37,3,3,229,0,1
185,2016-07-08,184,43,4,3,227,0,1
186,2016-07-09,145,85,5,3,230,0,0
187,2016-07-10,185,94,6,3,279,0,0
188,2016-07-11,187,47,0,3,234,0,1
189,2016-07-12,217,40,1,3,257,0,1
190,2016-07-13,241,47,2,3,288,0,1
191,2016-07-14,187,52,3,3,239,0,1
192,2016-07-15,190,55,4,3,245,0,1
193,2016-07-16,131,156,5,3,287,0,0
194,2016-07-17,145,162,6,3,307,0,0
195,2016-07-18,149,39,0,3,188,0,1
196,2016-07-19,200,46,1,3,246,0,1
197,2016-07-20,211,62,2,3,273,0,1
198,2016-07-21,213,56,3,3,269,0,1
199,2016-07-22,199,58,4,3,257,0,1
200,2016-07-23,120,92,5,3,212,0,0
201,2016-07-24,110,59,6,3,169,0,0
202,2016-07-25,166,45,0,3,211,0,1
203,2016-07-26,183,39,1,3,222,0,1
204,2016-07-27,168,43,2,3,211,0,1
205,2016-07-28,168,41,3,3,209,0,1
206,2016-07-29,156,68,4,3,224,0,1
207,2016-07-30,106,71,5,3,177,0,0
208,2016-07-31,129,80,6,3,209,0,0
209,2016-08-01,209,54,0,3,263,0,1
210,2016-08-02,220,58,1,3,278,0,1
211,2016-08-03,200,63,2,3,263,0,1
212,2016-08-04,209,80,3,3,289,0,1
213,2016-08-05,198,69,4,3,267,0,1
214,2016-08-06,127,95,5,3,222,0,0
215,2016-08-07,120,97,6,3,217,0,0
216,2016-08-08,207,58,0,3,265,0,1
217,2016-08-09,187,50,1,3,237,0,1
218,2016-08-10,206,50,2,3,256,0,1
219,2016-08-11,186,48,3,3,234,0,1
220,2016-08-12,156,53,4,3,209,0,1
221,2016-08-13,107,70,5,3,177,0,0
222,2016-08-14,96,49,6,3,145,0,0
223,2016-08-15,141,39,0,3,180,0,1
224,2016-08-16,160,49,1,3,209,0,1
225,2016-08-17,166,44,2,3,210,0,1
226,2016-08-18,210,50,3,3,260,0,1
227,2016-08-19,194,58,4,3,252,0,1
228,2016-08-20,127,105,5,3,232,0,0
229,2016-08-21,104,49,6,3,153,0,0
230,2016-08-22,190,58,0,3,248,0,1
231,2016-08-23,236,44,1,3,280,0,1
232,2016-08-24,194,43,2,3,237,0,1
233,2016-08-25,212,35,3,3,247,0,1
234,2016-08-26,180,56,4,3,236,0,1
235,2016-08-27,132,83,5,3,215,0,0
236,2016-08-28,125,75,6,3,200,0,0
237,2016-08-29,190,36,0,3,226,0,1
238,2016-08-30,200,48,1,3,248,0,1
239,2016-08-31,203,40,2,3,243,0,1
240,2016-09-01,179,34,3,3,213,0,1
241,2016-09-02,186,61,4,3,247,0,1
242,2016-09-03,123,119,5,3,242,0,0
243,2016-09-04,101,132,6,3,233,0,0
244,2016-09-05,118,109,0,3,227,1,0
245,2016-09-06,200,41,1,3,241,0,1
246,2016-09-07,188,36,2,3,224,0,1
247,2016-09-08,173,37,3,3,210,0,1
248,2016-09-09,189,34,4,3,223,0,1
249,2016-09-10,127,72,5,3,199,0,0
250,2016-09-11,133,101,6,3,234,0,0
251,2016-09-12,208,43,0,3,251,0,1
252,2016-09-13,225,40,1,3,265,0,1
253,2016-09-14,210,41,2,3,251,0,1
254,2016-09-15,215,48,3,3,263,0,1
255,2016-09-16,209,57,4,3,266,0,1
256,2016-09-17,155,84,5,3,239,0,0
257,2016-09-18,141,64,6,3,205,0,0
258,2016-09-19,160,24,0,3,184,0,1
259,2016-09-20,199,39,1,3,238,0,1
260,2016-09-21,207,31,2,3,238,0,1
261,2016-09-22,232,48,3,3,280,0,1
262,2016-09-23,218,54,4,3,272,0,1
263,2016-09-24,165,110,5,3,275,0,0
264,2016-09-25,160,92,6,3,252,0,0
265,2016-09-26,175,31,0,3,206,0,1
266,2016-09-27,198,39,1,3,237,0,1
267,2016-09-28,149,24,2,3,173,0,1
268,2016-09-29,104,10,3,3,114,0,1
269,2016-09-30,157,19,4,3,176,0,1
270,2016-10-01,94,22,5,3,116,0,0
271,2016-10-02,150,64,6,3,214,0,0
272,2016-10-03,209,43,0,3,252,0,1
273,2016-10-04,192,36,1,3,228,0,1
274,2016-10-05,218,51,2,3,269,0,1
275,2016-10-06,204,48,3,3,252,0,1
276,2016-10-07,188,64,4,3,252,0,1
277,2016-10-08,73,29,5,3,102,0,0
278,2016-10-09,138,86,6,3,224,0,0
279,2016-10-10,143,75,0,3,218,0,1
280,2016-10-11,181,38,1,3,219,0,1
281,2016-10-12,198,48,2,3,246,0,1
282,2016-10-13,206,40,3,3,246,0,1
283,2016-10-14,193,47,4,3,240,0,1
284,2016-10-15,143,103,5,3,246,0,0
285,2016-10-16,140,66,6,3,206,0,0
286,2016-10-17,176,50,0,3,226,0,1
287,2016-10-18,204,37,1,3,241,0,1
288,2016-10-19,201,47,2,3,248,0,1
289,2016-10-20,195,36,3,3,231,0,1
290,2016-10-21,148,41,4,3,189,0,1
291,2016-10-22,129,69,5,3,198,0,0
292,2016-10-23,123,87,6,3,210,0,0
293,2016-10-24,201,34,0,3,235,0,1
294,2016-10-25,196,27,1,3,223,0,1
295,2016-10-26,174,25,2,3,199,0,1
296,2016-10-27,172,13,3,3,185,0,1
297,2016-10-28,199,33,4,3,232,0,1
298,2016-10-29,136,101,5,3,237,0,0
299,2016-10-30,121,70,6,3,191,0,0
300,2016-10-31,187,30,0,3,217,0,1
301,2016-11-01,200,32,1,3,232,0,1
302,2016-11-02,226,31,2,3,257,0,1
303,2016-11-03,212,49,3,3,261,0,1
304,2016-11-04,182,54,4,3,236,0,1
305,2016-11-05,154,82,5,3,236,0,0
306,2016-11-06,135,80,6,3,215,0,0
307,2016-11-07,168,33,0,3,201,0,1
308,2016-11-08,180,31,1,3,211,0,1
309,2016-11-09,136,18,2,3,154,0,1
310,2016-11-10,168,33,3,3,201,0,1
311,2016-11-11,156,62,4,3,218,1,0
312,2016-11-12,108,74,5,3,182,0,0
313,2016-11-13,99,54,6,3,153,0,0
314,2016-11-14,177,22,0,3,199,0,1
315,2016-11-15,160,30,1,3,190,0,1
316,2016-11-16,172,19,2,3,191,0,1
317,2016-11-17,179,22,3,3,201,0,1
318,2016-11-18,183,46,4,3,229,0,1
319,2016-11-19,93,48,5,3,141,0,0
320,2016-11-20,61,15,6,3,76,0,0
321,2016-11-21,129,9,0,3,138,0,1
322,2016-11-22,137,17,1,3,154,0,1
323,2016-11-23,147,24,2,3,171,0,1
324,2016-11-24,31,34,3,3,65,1,0
325,2016-11-25,52,62,4,3,114,0,1
326,2016-11-26,51,43,5,3,94,0,0
327,2016-11-27,70,23,6,3,93,0,0
328,2016-11-28,161,11,0,3,172,0,1
329,2016-11-29,125,10,1,3,135,0,1
330,2016-11-30,87,7,2,3,94,0,1
331,2016-12-01,161,15,3,3,176,0,1
332,2016-12-02,159,22,4,3,181,0,1
333,2016-12-03,97,27,5,3,124,0,0
334,2016-12-04,80,18,6,3,98,0,0
335,2016-12-05,158,14,0,3,172,0,1
336,2016-12-06,86,4,1,3,90,0,1
337,2016-12-07,137,20,2,3,157,0,1
338,2016-12-08,151,13,3,3,164,0,1
339,2016-12-09,123,7,4,3,130,0,1
340,2016-12-10,67,18,5,3,85,0,0
341,2016-12-11,67,18,6,3,85,0,0
342,2016-12-12,120,14,0,3,134,0,1
343,2016-12-13,130,5,1,3,135,0,1
344,2016-12-14,133,16,2,3,149,0,1
345,2016-12-15,90,2,3,3,92,0,1
346,2016-12-16,84,5,4,3,89,0,1
347,2016-12-17,36,8,5,3,44,0,0
348,2016-12-18,52,8,6,3,60,0,0
349,2016-12-19,123,12,0,3,135,0,1
350,2016-12-20,119,5,1,3,124,0,1
351,2016-12-21,121,6,2,3,127,0,1
352,2016-12-22,110,8,3,3,118,0,1
353,2016-12-23,74,7,4,3,81,0,1
354,2016-12-24,27,5,5,3,32,0,0
355,2016-12-25,23,21,6,3,44,1,0
356,2016-12-26,36,20,0,3,56,0,1
357,2016-12-27,89,25,1,3,114,0,1
358,2016-12-28,94,34,2,3,128,0,1
359,2016-12-29,67,22,3,3,89,0,1
360,2016-12-30,64,19,4,3,83,0,1
361,2016-12-31,44,14,5,3,58,0,0
